000000000000000000000
111111111111111111110
000000000000000000010
000010101111101111010
011110101000101000010
010011111000101111110
000000000000100000000